#######______#######
#__________________#
#__________________#
#__________________#
#__________________#
#__________________#
#__________________#
#__________________#
_________#__________
_________#__________
_________#__________
_________#__________
#__________________#
#__________________#
#__________________#
#__________________#
#__________________#
#__________________#
#__________________#
#######______#######