####################
#__________________#
#___#______________#
#___#______________#
#___#______________#
#__________________#
#__________________#
#__________________#
#__________________#
#__________#_______#
#_________###______#
#__________#_______#
____________________
#__________________#
#____######________#
#______#___________#
#______#___________#
#__________________#
#__________________#
####################