#######______#######
#__________________#
#__________________#
#__________________#
#__________________#
#__________________#
#__________________#
#__________________#
#_______###________#
#_______###________#
#_______###________#
#_______###________#
#__________________#
#__________________#
#__________________#
#__________________#
##________________##
##________________##
#__________________#
#######______#######