#######______#######
#__________________#
#__________________#
#__________________#
#__________________#
#__________________#
#__________________#
#__________________#
____________________
____________________
____________________
____________________
#__________________#
#__________________#
#__________________#
#__________________#
#__________________#
#__________________#
#__________________#
#######______#######